s	s	s	s	s	s	s	s	s	s	s	s	s	s	s	s	s	s	s	s	s	s	s	s	s	s	s	s	s	s	s	s	s	s	s	s	s	s	s	s
s	s	s	s	s	s	s	s	s	s	s	s	s	s	s	s	s	s	s	s	s	s	s	s	s	s	s	s	s	s	s	s	s	s	s	s	s	s	s	s
s	s	s	s	s	s	s	s	s	s	s	s	s	s	s	s	s	s	s	s	s	s	s	s	s	s	s	s	s	s	s	s	s	s	s	s	s	s	s	s
s	s	s	s	s	s	s	s	s	s	s	s	s	s	s	s	s	s	s	i	s	s	s	s	s	s	s	s	s	s	s	s	s	s	s	s	s	s	s	s
s	s	s	s	s	s	s	s	s	s	s	c	s	s	s	s	s	s	s	s	s	s	s	s	s	s	s	s	s	s	s	s	s	s	s	s	s	s	s	s
s	s	s	s	s	s	i	s	s	s	m	i	s	s	s	s	s	s	s	s	s	s	s	s	s	s	s	s	s	s	s	s	s	s	s	s	s	s	s	s
s	s	s	s	s	i	c	s	s	s	m	i	c	s	s	p	p	p	p	p	p	s	s	s	i	s	s	s	s	t	s	s	s	s	s	s	s	s	s	s
s	s	s	s	s	s	s	s	s	s	m	s	s	s	s	s	s	i	s	s	s	s	s	s	s	s	s	s	s	s	s	s	s	s	s	s	s	s	s	s
s	s	s	s	s	s	s	s	s	s	m	s	i	s	s	s	s	c	s	s	s	s	s	s	s	s	s	s	s	s	s	s	s	s	s	s	s	s	s	s
s	s	s	s	s	s	s	s	s	i	m	s	s	s	s	s	s	s	s	s	s	s	i	c	i	s	s	s	s	s	s	s	c	i	s	s	s	s	s	s
s	s	s	s	i	s	s	s	c	i	m	s	s	s	s	s	s	s	s	s	s	s	i	i	i	s	s	s	s	s	s	i	i	i	c	s	s	s	s	s
s	s	s	s	c	s	s	s	s	c	s	s	s	s	s	s	s	s	p	p	p	p	p	p	p	p	p	p	s	s	s	s	s	s	s	s	s	s	s	s
s	s	s	s	s	s	s	s	s	s	s	s	s	s	s	s	s	s	s	i	s	s	s	s	i	s	s	s	s	s	s	s	s	s	s	s	s	s	s	s
s	s	s	s	s	s	s	s	s	s	s	s	s	s	s	i	c	s	s	s	s	s	s	s	i	c	s	s	s	s	s	s	s	s	s	s	s	s	s	s
s	s	s	i	s	p	s	s	s	s	s	i	s	s	s	c	i	s	s	s	s	s	s	s	s	s	s	s	s	s	s	m	s	s	i	s	s	s	s	s
s	s	s	s	s	p	s	s	s	s	s	s	s	s	s	s	s	s	s	s	s	s	m	m	s	s	s	s	s	s	s	m	i	c	i	s	s	s	s	s
s	s	s	s	s	p	i	s	p	p	p	p	p	p	s	s	s	s	i	i	s	s	s	m	i	c	s	s	c	s	s	m	i	s	s	s	s	s	s	s
s	s	s	s	s	p	s	s	i	i	s	s	s	s	s	s	s	s	s	i	t	s	i	m	s	s	s	s	s	s	s	m	s	s	s	s	s	s	s	s
s	s	s	s	s	p	s	s	s	c	s	s	s	s	s	s	s	p	s	s	s	s	s	m	s	s	s	s	s	s	s	m	s	s	s	s	s	s	s	s
s	s	s	s	s	p	s	s	s	s	s	s	i	s	s	s	s	p	s	s	s	s	s	m	s	s	s	s	i	s	c	m	s	s	i	s	s	s	s	s
s	s	s	i	s	p	s	t	s	s	s	s	s	s	s	i	s	p	s	s	s	s	s	s	s	s	s	s	c	i	i	m	s	s	s	s	s	s	s	s
s	s	s	s	s	s	s	i	s	s	s	s	s	s	s	c	s	p	s	s	s	s	i	i	s	s	s	s	s	s	s	m	s	s	s	s	s	s	s	s
s	s	s	s	s	s	s	s	m	m	m	m	m	s	s	i	s	p	s	i	c	s	s	s	s	s	s	s	s	s	s	m	i	s	s	s	i	s	s	s
s	s	s	s	s	i	s	s	s	s	s	s	i	s	s	s	s	p	s	i	s	s	s	s	s	s	s	i	c	s	s	s	s	s	s	s	s	s	s	s
s	s	s	s	s	s	s	s	s	s	s	i	c	i	s	s	s	s	s	s	s	s	s	s	s	s	s	s	s	s	s	s	s	s	s	s	s	s	s	s
s	s	s	s	s	s	s	s	s	s	s	s	s	s	s	s	s	s	s	s	s	i	i	c	s	s	s	s	s	i	i	c	i	s	s	s	s	s	s	s
s	s	s	s	s	s	i	s	s	s	s	s	s	s	s	s	p	p	p	s	s	s	s	i	s	s	i	s	s	s	s	s	s	s	s	s	s	s	s	s
s	s	s	s	s	s	i	c	i	s	s	s	s	s	s	s	s	s	p	s	s	s	s	s	s	s	i	s	s	p	p	p	p	p	s	c	s	s	s	s
s	s	s	s	s	s	s	s	s	s	s	s	s	s	s	s	s	s	p	p	p	s	s	i	s	s	s	s	p	p	s	s	s	s	s	s	s	s	s	s
s	s	s	s	s	s	s	p	p	p	p	p	s	s	g	g	s	s	s	s	p	s	s	s	s	s	s	p	p	s	s	s	s	s	s	i	s	s	s	s
s	s	s	s	s	s	s	s	s	s	s	s	s	s	g	g	g	s	s	s	p	s	s	s	s	s	s	s	s	s	c	s	s	s	s	s	s	s	s	s
s	s	s	s	c	i	s	s	s	i	s	s	s	g	g	g	g	g	s	s	p	p	p	s	c	s	s	s	s	s	s	s	s	s	s	s	s	s	s	s
s	s	s	s	s	s	s	s	s	s	s	s	s	g	g	g	g	g	s	s	s	s	s	s	s	s	s	s	s	s	s	s	s	s	s	s	s	s	s	s
s	s	s	s	s	s	s	s	s	s	s	s	g	g	g	g	g	g	s	s	s	s	s	s	s	s	s	s	s	s	s	s	s	s	s	s	i	s	s	s
s	s	s	s	s	s	s	s	s	s	s	s	g	g	g	g	g	g	g	s	s	s	s	s	s	s	s	s	s	i	s	s	s	s	s	s	s	s	s	s
s	s	s	s	s	s	s	s	s	s	s	s	g	g	g	g	g	g	g	s	s	s	s	s	s	s	s	s	s	s	s	s	s	s	s	s	s	s	s	s
s	s	s	s	s	s	s	s	s	s	s	g	g	g	g	g	g	g	g	g	s	s	s	s	s	s	s	s	s	s	s	s	s	s	s	s	s	s	s	s
s	s	s	s	s	s	s	s	s	s	s	g	g	g	g	g	g	g	g	g	g	g	g	s	s	s	s	s	s	s	s	s	s	s	s	s	s	s	s	s
s	s	s	s	s	s	s	s	s	s	s	g	g	g	g	g	g	g	g	g	g	g	g	g	g	g	s	s	s	s	s	s	s	s	s	s	s	s	s	s
s	s	s	s	s	s	s	s	s	g	g	g	g	g	g	g	g	g	g	g	g	g	g	g	g	g	s	s	s	s	s	s	s	s	s	s	s	s	s	s
